wwwwwwwwwwwwwwwwwwwwwwwwwwwwwww
w.............................w
w.............................w
w.............................w
w.............................w
w.............................w
w.............................w
w.............................w
w.............................w
w.............................w
w.............................w
w.............................w
w.............................w
w.............................w
w.............................w
w.............................w
w.............................w
w.............................w
w.............................w
w.............................w
w.............................w
w.............................w
w.............................w
w.............................w
w.............................w
w........................s....w
w........................s....w
w......................m..s...w
w....................wwwww....w
w.................wwww....s.s.w
w.................w.........s.w
w.................wm.........iw
wwwwwwwwwwwwwwwwwwwwwwwwwwwwwww