wwwwwwwwwwwwwwwwwwwwwwwwwwwwwww
w..........................k..w
w......................wswwww.w
w....wwsww..............s.....w
w......s................s...m.w
w......s...............wwwsww.w
wo.....s..m...............s...w
wwwwwswwwwwwsww...........s...w
w....s......s.............s...w
w....s......s.............s...w
w....s..s..wwswwwwwsww..wwwww.w
w....s..s....s.....s..........w
w....s..ss..ms.....s..........w
w........swwwwwwswwwww........w
w.s......s......s.............w
w.s......s......s.............w
w.s.......w.....s.............w
w.s......w......s.............w
w.s.m...w.....................w
w.swwwwwwwwsw.w.w.w.w.wwwwwwwww
w.s........s.................sw
w.s..m.....s....w...w.w.wwwwwsw
w.wwwwwwwwww......w..........sw
w..........w.................sw
w.........w......wwwwww.......w
w........w.......m....w..wwwwww
w.......w....wwwswwwwww.......w
w......w........s.............w
w.....w.........s.............w
w....w..........s.............w
w...w...........s.............w
w....m..........s............iw
wwwwwwwwwwwwwwwwwwwwwwwwwwwwwww