wwwwwwwwwwwwwwwwwwwwwwwwwwwwwww
w..........................k..w
w......................wswwww.w
w.......................s.....w
w.......................s...m.w
w......................wwwsww.w
wo........................s...w
wwwwwwwwwwwwsww...........s...w
w...........s.............s...w
w...........s.............s...w
w..........wwswwwwwsww..wwwww.w
w............s.....s..........w
w...........ms.....s..........w
w.wwwswww..wwwwwwwwwww........w
w....s.......................iw
wwwwwwwwwwwwwwwwwwwwwwwwwwwwwww