wwwwwwwwwwwwwwwwwwwwwwwwwwwwwwwwwwwwwwwwwwwwwww
w........o....................................w
w........s....................................w
w........s.gggg...............................w
w........swwwwwws.............................w
w........s......s.............................w
w........s......s.............................w
w........s......s.............................w
w........s......s....g.ggg....................w
w........s......swwwwwwwwwwwwwws..............w
w........s......s..............s..............w
w....M...s......s..............s..............w
w........s......s.....ggg......s....i.........w
wwwwwwwwwwwwwwwwwwwwwwwwwwwwwwwwwwwwwwwwwwwwwww