wwwwwwwwwwwwwwwwwwwwwwwwwwwwwww
w..........................k..w
w......................wswwww.w
w....wwsww..............s.....w
w......s................s...m.w
w......s...............wwwsww.w
wo.....s..................s...w
wwwwwswwwwwwsww...........s...w
w....s......s.............s...w
w....s......s.............s...w
w....s..s..wwswwwwwsww..wwwww.w
w....s..s....s.....s..........w
w....s..ss..ms.....s..........w
w........swwwwwwswwwww........w
w........s......s.............w
w........s......s.............w
w.........w.....s.............w
w........w......s.............w
w.......w.......s.............w
w..wwwww........s.....wwwwwwwww
w...............s.............w
w...............s............iw
w...............s............iw
w...............s............iw
w...............s............iw
w...............s............iw
w...............s............iw
w...............s............iw
w...............s............iw
w...............s............iw
w...............s............iw
w...............s............iw
wwwwwwwwwwwwwwwwwwwwwwwwwwwwwww