wwwwwwwwwwwwwwwwwwwwwwwwwwwwwww
w..........................k..w
w......................wswwww.w
w.......................s.....w
w.......................s...m.w
w......................wwwsww.w
wo........................s...w
wwwwwwwwwwwwsww...........s...w
w...........s.............s...w
w...........s.............s...w
w..........wwswwwwwswww.wwwww.w
w............s.....s..........w
w...........ms.....s..........w
w.wwwswww..wwwwwswwwww........w
w....s..........s............iw
wwwwwwwwwwwwwwwwwwwwwwwwwwwwwww