wwwwwwwwwwwwwwwwwwwwwwwwwwwwwww
w.............................w
w.............................w
w.............................w
w.............................w
w.............................w
w.............................w
w.............................w
w.............................w
w.............................w
w.............................w
w.............................w
w.............................w
w.............................w
w.............................w
w.............................w
w.............................w
w.............................w
w.............................w
w.............................w
w.............................w
w.............................w
w.............................w
w.............................w
w.............................w
w........................s....w
w........................s....w
w....................mggggs...w
w.................o.lwwwww....w
w.................wwww....s.s.w
w.................w.........s.w
w.................wm....k....iw
wwwwwwwwwwwwwwwwwwwwwwwwwwwwwww